edbEntry = {
    buildingID = int, -- 建筑ID
    localizedName = string, -- 本地化名称
    classification = int, -- 分类
    isCoreBuilding = int, -- 是否为核心建筑
    isPort = int, -- 是否为港口
    isWallBuilding = int, -- 是否为城墙建筑
    isTemple = int, -- 是否为寺庙
    religionID = int, -- 宗教ID
    isHinterland = int, -- 是否为腹地建筑
    isFarm = int, -- 是否为农场
    buildingLevelCount = int, -- 建筑等级数量
    getBuildingLevel = getBuildingLevel -- 获取建筑等级
}
buildingLevel = {
    name = string, -- 建筑等级名称
    genericBuildingPic = string, -- 通用建筑图片
    genericBuildingPicConstructed = string, -- 通用建筑建成图片
    genericBuildingPicConstruction = string, -- 通用建筑建造中图片
    buildCost = int, -- 建造费用
    buildTime = int, -- 建造时间
    capabilityNum = int, -- 能力数量
    recruitPoolNum = int, -- 招募池数量
    factionCapabilityNum = int, -- 派系能力数量
    settlementMinLvl = int, -- 定居点最低等级
    availableCastle = bool, -- 是否适用于城堡
    availableCity = bool, -- 是否适用于城市
    setBuildingPic = setBuildingPic, -- 设置建筑图片
    getBuildingPic = getBuildingPic, -- 获取建筑图片
    setBuildingPicConstructed = setBuildingPicConstructed, -- 设置建筑建成图片
    getBuildingPicConstructed = getBuildingPicConstructed, -- 获取建筑建成图片
    setBuildingPicConstruction = setBuildingPicConstruction, -- 设置建筑建造中图片
    getBuildingPicConstruction = getBuildingPicConstruction, -- 获取建筑建造中图片
    setLocalizedName = setLocalizedName, -- 设置本地化名称
    getLocalizedName = getLocalizedName, -- 获取本地化名称
    setLocalizedDescr = setLocalizedDescr, -- 设置本地化描述
    getLocalizedDescr = getLocalizedDescr, -- 获取本地化描述
    setLocalizedDescrShort = setLocalizedDescrShort, -- 设置本地化简短描述
    getLocalizedDescrShort = getLocalizedDescrShort, -- 获取本地化简短描述
    getCapability = getCapability, -- 获取能力
    getFactionCapability = getFactionCapability, -- 获取派系能力
    getRecruitPool = getRecruitPool, -- 获取招募池
    addCapability = addCapability, -- 添加能力
    addFactionCapability = addFactionCapability, -- 添加派系能力
    addRecruitPool = addRecruitPool, -- 添加招募池
    removeCapability = removeCapability, -- 移除能力
    removeFactionCapability = removeFactionCapability, -- 移除派系能力
    removeRecruitPool = removeRecruitPool -- 移除招募池
}
